NO ./texture/bricksx64_mod.xpm
EA ./texture/red_bricks.xpm
WE  ./texture/dark_prismarine.xpm
SO  ./texture/note_block.xpm

F 62,55,50
C 228,131,167

11111111
10100001
100010011
100N01001
100000011
10000001
11000001
11111111
