NO ./texture/bricksx64_mod.xpm
EA ./texture/red_bricks.xpm
WE  ./texture/dark_prismarine.xpm
SO  ./texture/note_block.xpm

F 62,55,50
C 228,131,167

111111111
101000011
100010011
100001001
100000011
1000E0011
110000011
100001011
111111111