NO ./texture/bricksx64_mod.xpm
EA ./texture/red_bricks.xpm
WE  ./texture/dark_prismarine.xpm
SO  ./texture/note_block.xpm

F0,0,0
C 255,5,1

1111111            1111111
1000001            1000001
1000001            1000001
100000111111       100000111111
100000000001       100000000001
100000000001       10S000000001
100000000001       100000000001
100000000001       100000000001
111110000001       111110000001
    10000001           10000001
    10000001           10000001
    11111111           11111111

1111111
1000001
1000001
100000111111
100000000001
100000000001
100000000001
100000000001
111110000001
    10000001
    10000001
    11111111
    