NO ./texture/bricksx64_mod.xpm
EA ./texture/red_bricks.xpm
WE  ./texture/dark_prismarine.xpm
SO  ./texture/note_block.xpm
F0,0,0
C 255,5,1

11111N
1000001
100N001
1111111